#LEVEL 5
DIM 15 12
TEMPO 80
MON 5.m 6.m
XXXXXXXXXXXXXXX
XoooXooooooXooX
XoXoXoXXXoXXooX
XoXoooXoXooXooX
XoXXXXXoXXoXooX
XooooooooXoooXX
XXXXXoXXXXXXoXX
XooXooXoooooooX
XoXXoXXoXXXXXoX
XoooooXooooXooX
XoXXXXXXXXoXXoX
Xooooooooo@oooX
XXXXXXXXXXXXXXX
